7 10
##########
#        #
#        #
#   e@   #
#        #
#        #
##########