7 13
#############
#     #     #
#  *  #     #
#  *  #     #
# @*  #   e #
#     #     #
#############
