7 8
########
#   #  #
# # #  #
# # # e#
#@# #  #
#      #
########
