7 7
#######
#   # #
# # # #
# # # #
#@# # #
#   #e#
#######
