8 11
###########
# #@  #####
#   # #####
# ### #####
#        ##
##### ## ##
#####    e#
###########
