21 77
#############################################################################
#@  #             # # #   #     #       #   # #   # # #       #     #       #
# # # ############# # # # # ##### ##### ### # ### # # # # # ####### # ### # #
# # # #     # #   # #   #     # #   #         #     #   # #       #   # # # #
# ### ### ### ### # ####### ### # ### ######### ####### ####### ### ### # # #
#   #   # #     #   #   #         #               # #     #   #   #   # # # #
### # # # # # ##### ### # ####### ### # ### ##### # ### # # # ##### # # # ###
#   # # #   #     #           #   # # #   #     #   #   #   # #     #   #   #
# # # ####### ### # ##### # ####### ### ### ####### ### ######### # # ### ###
# # #   #   # #     # #   #   #     #   #   # # #         # # # # # # #   # #
### # # # # ### # # # # ######### # ####### # # ##### ### # # # # ####### # #
#     # # #     # # #             #   # # #   # # #   #     # # #   #       #
# ##### ### # # ######### # ######### # # # ### # ### ####### # ### # # ### #
# # #       # #     # #   #     # # #         #                 # #   # #   #
# # ### ### # # ##### # ######### # ### ############# ##### ### # ##### # ###
# # #     # # #       #   # #         #     #   #       #   #       #   #   #
### # ##### ####### ##### # # ### # # ### # # # # ####### # ### ### # ##### #
#       #     #       #     # #   # #     #   # # #   #   #   # # # #   #   #
# # ######### ### ### # # ### # ##### ### ####### # ### # ### # # # # # # ###
# #     #       # #   # #   # #   #   #   #           # # #   # #     # #  e#
#############################################################################
