8 13
#############
#@# #   #   #
#   # # # # #
# ### # # # #
#     #   # #
# ##### #####
#   #      e#
#############
