8 13
#############
# # #e  # e #
#   #e# # # #
# ### #e# # #
#     #   # #
# ##### ### #
#   #    @ e#
#############
